Id	int	Unchecked
Id_xCalibratura	int	Unchecked
Variety	varchar(50)	Unchecked
Cd_ARLotto	varchar(20)	Unchecked
caliber	decimal(18, 0)	Unchecked
Cd_CF	char(7)	Unchecked
TotalKgOrder	decimal(18, 0)	Unchecked
Date	date	Unchecked
AnalysisTime	varchar(50)	Unchecked
Sample	decimal(18, 0)	Unchecked
Skin	bit	Unchecked
TargetSkin	int	Unchecked
TastAndSmell	bit	Unchecked
Colour	bit	Unchecked
SampleCalibration	decimal(18, 0)	Unchecked
OverSize	decimal(18, 0)	Unchecked
OverSizePercentage	int	Unchecked
Calculation	decimal(18, 0)	Unchecked
CalculationPercentage	int	Unchecked
UnderSize	decimal(18, 0)	Unchecked
UnderSizePercentage	int	Unchecked
Total	decimal(18, 0)	Unchecked
Observations	text	Unchecked
TargetCalibration	int	Unchecked
Id_Operatore	int	Unchecked
UserIns	varchar(48)	Unchecked
UserUpd	varchar(48)	Unchecked
TimeIns	smalldatetime	Unchecked
TimeUpd	smalldatetime	Unchecked
Ts	timestamp	Checked
Cd_AR	varchar(20)	Unchecked
moisture	decimal(18, 0)	Unchecked